##########
#........#
#.###.##.#
#.#...#..#
#.###.#.+#
#.....#..#
#.###.##.#
#.#>.....#
#.#......#
##########