##########
#........#
#...##...#
#...+....#
#...##...#
#........#
#........#
#......>.#
#........#
##########