##########
#........#
#.#....#.#
#..#...#.#
#...##...#
#...##...#
#........#
#.#....###
#..#....>#
##########